#################################################################### 
#                                                                  # 
#                 CO2 DRIVERS EU - ANALYSIS                        # 
#                                                                  # 
#################################################################### 

 
 
############################## 
#  COUNTRIES = 15 
############################## 

 
 